XXXXX
X H X
X X X
X X X
X   X
  X
 XXX
F F
X F X
XXXXX